{
  "c": "g",
  "a": "e",
  "k": "n",
  "o": "r",
  "z": "a",
  "i": "l",
  "e": "b",
  "l": "o",
  "p": "s",
  "q": "t",
  "r": "d",
  "t": "u",
  "b": "c",
  "j": "m",
  "f": "i"
}